⠿⠿⠿⠿⠿⠿⠿⠿⠿⠿⠿⠿⠿⠿⠿⠿⠿⠿⠿⠿⠿⠿⠿⠿⠿⠿⠿⠿⠿⠿⠿⠿⠿⠿⠿⠿⠿⠿⠿⠿⠿⠿⠿⠿⠿⠿⠿⠿⠿⠿
⠿                                                ⠿
⠿                                                ⠿
⠿                                                ⠿
⠿                                                ⠿
⠿                                                ⠿
⠿                                                ⠿
⠿                                                ⠿
⠿                                                ⠿
⠿                                                ⠿
⠿                   ⠿⠿⠿⠿⠿⠿⠿                      ⠿
⠿                   ⠿     ⠿                      ⠿
⠿                   ⠿     ⠿                      ⠿
⠿                   ⠿⠿⠿ ⠿⠿⠿                      ⠿
⠿                                                ⠿
⠿                                                ⠿
⠿                                                ⠿
⠿                                                ⠿
⠿                                                ⠿
⠿⠿⠿⠿⠿⠿⠿⠿⠿⠿⠿                                      ⠿
          ⠿                                      ⠿
          ⠿                                      ⠿
          ⠿                                      ⠿
          ⠿                                      ⠿
          ⠿⠿⠿⠿⠿⠿⠿⠿⠿⠿⠿⠿⠿⠿⠿⠿⠿⠿⠿⠿⠿⠿⠿⠿⠿⠿⠿⠿⠿⠿⠿⠿⠿⠿⠿⠿⠿⠿⠿⠿